########################################
#......................................#
#.###########.....###########.........#
#.#.........#.....#.........#.........#
#.#.........#.....#.........#.........#
#.#.........#.....#.........#.........#
#.#.........#.....#.........#.........#
#.###########.....###########.........#
#......................................#
#......................................#
#......................................#
#.....#########.....#########.........#
#.....#.......#.....#.......#.........#
#.....#.......#.....#.......#.........#
#.....#.......#.....#.......#.........#
#.....#########.....#########.........#
#......................................#
#......................................#
#......................................#
#......................................#
########################################
